11111111
100001C1
100001E1
1P000001
11111111