11111101
100PEC00
10000C01
11111101