11111101
100PEC01
10000000
11111101