11111111111111111111111
100000      11111111111
1PEC1100000000000000001
11111111111111111111111