1111111111111111111111111
1P1010101000C000000000001
1CCCCCCCCC111111111110001
1C000000001ECCCCCCCC10001
1C0000C0C01CCCCCCCCC00001
10000000001CCCCCCCCC10001
1000000000111111111110001
10000000C0000C000C0000001
1111111111111111111111111