111111111111111111111111111111
10P000001111111111111E00000C01
11CCCC000000000000110000000C01
1111000000010000010000000CCC01
11111000000100001000CCCCCCCC01
111000000001000111111110000001
110000000000000000000010000001
10000000CCCCCCCCCC000000000001
111111111111111111111111111111