111111
1E01P1
10C101
1C0C01
111111