111111
1E01P1
10C101
100C01
111111