1111111111111111111111111111111111111111111
1P00000000000000000000001111111111111111111
10000C000000C0000000000001CCCC0100000000001
1000000000000000000000000010CC001000CCCC001
11111110000000CCCCCC0000000100C001000000001
10CC00100000000CCCCC0000000010000010CCCC001
10CC000000000000000CC000000000C00000000E001
1111111000000000000000000000100000100000001
1CCC00011000000CCCCC00000001000001000000001
1CCC00000010000000000000001000C010000000CC1
1CCC000000100000000000000100CCC100000000001
1111111111111111111111111111111111111111111