1111111111111111111111111
101P101010101010101010101
10000000000000C00C000C001
101010101010101E101010101
1111111111111111111111111