111111
1PCCC11
11000011
1C1110C111
1C11110E11
1111111111