1111111111111
10P00000000E1
1111111111111