11111111111
1PCCCCC0001
11111111111