11111111111
10C000000E1
11111111111