1111111111
1P1C000E11
1011111111
1111111111