111111111111111
1P000000000001
1000000000001
100C00000001
1E000000001
1000000001
100000001
10000001
1000001
100001
10001
1001
101
11
1